80
7
14 0 0 0 0 0 0 0 0 0 0 0 0 0 0 0 0 0 0 0 0 0 0 0 0 0 0 0 0 0 0 0 0 0 0 0 0 0 0 0 0 0 0 0 0 0 0 0 0 0 0 0 0 0 0 0 0 0 0 0 0 0 0 0 0 0 0 0 0 0 0 0 0 0 0 0 0 0 0 0
14 0 0 0 0 0 0 0 0 0 0 0 0 0 0 0 0 0 0 0 0 0 0 0 0 0 0 0 0 0 0 0 0 0 0 0 0 0 0 0 0 0 0 0 0 0 0 0 0 0 0 0 0 0 0 0 0 0 0 0 0 0 0 0 0 0 0 0 0 0 0 0 0 0 0 0 0 0 0 0
14 0 0 0 0 0 0 0 0 0 0 0 0 0 0 0 0 0 0 0 0 0 0 0 0 0 0 0 0 0 0 0 0 0 0 0 0 0 0 0 0 0 8 0 0 0 0 0 9 0 0 0 0 0 0 0 0 0 0 0 0 0 0 0 0 0 0 0 0 0 0 0 0 0 0 0 0 0 0 0
14 0 0 0 0 0 0 0 0 0 9 0 0 0 9 0 0 0 0 0 9 0 0 0 0 0 0 0 0 0 0 0 0 0 0 0 0 0 0 0 0 0 14 8 9 8 8 8 14 0 0 0 0 0 0 0 0 0 0 0 0 0 0 0 0 0 0 0 0 0 0 0 0 0 0 0 0 0 0 0
14 0 0 0 0 0 0 0 0 0 14 8 9 9 14 0 0 8 0 0 14 0 0 0 0 0 0 0 9 0 0 0 0 8 0 0 0 9 9 8 0 0 0 0 0 0 0 0 0 0 0 8 0 0 0 8 9 8 9 0 0 0 0 0 0 0 0 0 0 0 0 0 9 8 9 9 8 9 8 8
14 0 0 0 0 0 0 9 0 0 14 14 14 14 14 0 0 14 0 0 14 0 0 0 0 0 0 0 14 8 9 9 8 14 0 0 0 14 14 14 8 0 0 0 0 0 0 0 0 0 9 14 0 0 0 14 14 14 14 0 0 0 8 0 0 0 0 0 0 9 0 0 14 14 14 14 14 14 14 14
14 8 8 9 8 9 8 14 0 0 14 14 14 14 14 0 0 14 0 0 14 0 0 0 0 8 0 0 14 14 14 14 14 14 0 0 0 14 14 14 14 8 9 8 9 8 9 8 9 8 14 14 0 0 0 14 14 14 14 0 0 0 14 8 9 8 9 8 9 14 0 0 14 14 14 14 14 14 14 14