64
7
14 0 0 2 0 0 0 0 0 0 0 0 0 0 0 0 0 0 0 0 0 0 0 0 0 0 1 0 1 0 0 0 0 0 0 1 0 1 0 0 0 0 0 0 0 0 0 0 0 0 0 0 0 0 0 0 0 0 0 0 0 0 0 0
14 0 1 1 1 2 0 0 0 0 0 0 0 2 3 0 0 0 0 0 0 0 0 1 2 0 0 1 0 0 0 0 0 0 0 3 1 2 0 0 0 0 0 0 0 0 0 0 0 0 0 0 0 0 0 0 0 0 0 0 0 0 0 0
14 0 1 0 0 1 0 0 1 1 0 0 0 1 0 0 0 9 0 0 0 9 0 1 0 0 0 0 0 0 0 0 0 0 0 1 0 1 0 0 0 0 0 0 0 0 0 0 0 0 0 0 0 0 0 0 0 0 0 0 0 0 0 0
14 0 3 2 0 0 0 0 3 2 0 0 0 0 0 0 0 14 8 8 9 14 0 0 0 0 8 0 0 8 9 0 0 0 0 0 0 0 0 0 0 0 8 0 9 0 0 8 8 8 0 0 0 0 0 0 0 0 9 0 0 0 0 9 0
14 0 0 0 0 0 0 0 0 0 8 8 9 8 9 8 0 0 0 0 0 0 0 8 0 0 14 0 0 14 14 8 9 9 8 0 0 0 0 0 8 0 14 0 14 0 0 14 14 14 0 0 0 0 0 0 0 0 14 9 8 8 9 14
14 0 0 0 0 0 0 9 0 0 14 14 14 14 14 14 8 0 0 0 0 8 9 14 0 0 14 0 0 14 14 14 14 14 14 0 0 0 0 0 14 0 14 0 14 0 0 14 14 14 0 8 0 0 0 0 8 0 14 14 14 14 14 14
14 8 8 9 8 9 8 14 0 0 14 14 14 14 14 14 14 8 9 9 8 14 14 14 0 0 14 0 0 14 14 14 14 14 14 0 0 0 8 8 14 0 14 0 14 0 0 14 14 14 0 14 8 8 9 9 14 0 14 14 14 14 14 14