W W W W W W W W W W
W D W O C W O O C W
W O W O O W O C O W
W C O O O O O O W W
W O O O W O O W C W
W W W W W O O W O W
W C W O W O O W O W
W O O O W O O O O W
W O O O O O O O D W
W W W W W W W W W W